1111111111111111111111111111111111111111111111111111111111111
1E1CCC111CCCCC100010000000000010001C1000001CCC1CCC111CCC1C0C1
101CCC000000000010101CCC1CCC1000101C1010101CCC1CCC10000000P01
100CCC111CCCCC1110001CCC1CCC1110000000001000000000001CCC1C0C1
1111111111111111111111111111111111111111111111111111111111111
