1111111111111
1C0000001CCC1
1101100H00001
11V1P00001E01
1C00010101101
1C0001000H0C1
1111111111111
