1111111111111
100000001CCC1
1001100H00001
1001P0000E101
1000010001101
1000000000001
1111111111111
