11111
1P101
10101
1C1E1
11111
