11111111
1P101
10C01
101E1
11111
