11111
10001
10C01
100E1
11111
