11111
1P0E1
10C01
100E1
11111
