11111
1P101
10Q01
1C1E1
11111
