11111
1P001
10C01
1P0E1
11111
