1111111
1C1CCC1
1000101
1011101
1P1E001
1111111
