111111111111111111111
1CCC110C0V0C0H01C00C1
1010000000C000P00V0C1
100011V000000000000C1
101000001000H00100111
1C111100C0000C0000001
1010C1H00CH00011011V1
101011111111111101101
1C00CC111111111C00001
11101111CCCCC1100CC01
1C00CC11C0E0C1100CC01
10111111C000C11V00001
1000CC111101111C0CC01
1C101110H00H00100CC01
101111111101111110011
100H001C10001C0000011
1C0000000100101111111
1100011000001V0CCCC11
1C0C0C1V0000101CCCCC1
1C0C0C111110001CCCC11
111111111111111111111
