11111111111111111111111
1CC10001V00000001CCCCC1
1CC00100010000C00000001
1C111111011111101110001
1110P010001VCCC0100H001
1H0000001010CCC01011101
1111101110000000100E001
1CCC001CC01C000C1CC0CC1
11111111111111111111111
