11111111111111
1CCC1111CV00C1
101111111011C1
10100H001011C1
101010000000C1
10001011111111
1111101C00H0`C1
1CCCC0101CC101
11111010C00C01
1110H0101CC101
111P0000C00C01
1C1110101CC101
10H0001CH000C1
10C1C011110111
10C1C00CC10001
10000V1CC11101
1101111111C101
10001C0000H001
10E01C01C1C1C1
10001C01C1C1C1
11111111111111
