11111111111111111111111
1CC10001V0C1CC001CC1CC1
1CC0010001C0CC100000001
1C111111011111101110001
1110P010001C1CC0100H001
1H000000101C0CC01C11101
11111011100V0000100E001
1CCC001CC01C000C1CC0CC1
11111111111111111111111
