1111111111111111111111111111111111111111
1C0C0C0C0C0C0C0C0C0C111CCC01C1000001C0C1
10111111111111111110111111010101010C0101
1C100001CCCC0000001000000000000101101101
1010CC01111110111011111101111111010010C1
1C10CC000000001C1000000000C0C11101011011
10100001CCCC100010111111110C011100000001
1C11111111111110101C0C0C11C0C11111110001
1000000000001C0C10111110111111C0C0C10001
110111011101101110111000110000C0C0C11011
1C0C1C0C1C0C101100011011110001C0C0C10001
10C010C010C01C000P0000000001111111110E01
1C0C1C0C1C0C11110001111111C0C0C0C0C10001
1111111111111111111111111111111111111111
