11111111111111
10CCCC0111CCC1
10111100E11101
100CC101110001
101CC00C0C0101
1011110C0C01C1
1CCC1101111111
10001000001111
1CCC1011100111
1010100001CCC1
1CCC1C0P01C111
11111111111111
