111111111111111111111
1CCC110C0V0C0H01C00C1
1010000000C000P00V0C1
100011V000000000000C1
101000001000H00100111
1C111100C0000C0000001
10110H000CH00011011V1
101111111111111101101
1C00CC111111111C00001
11101111C000C1100CC01
1C00CC1100E001100CC01
10111111C000C11V00001
1000CC111101111C0CC01
1C101110H00000100CC01
101111111101111110011
100H001C10001C0000011
1C0000000100101111111
1100011000001V0000011
1C0C0C1V0000101C0C0C1
1C0C0C111110001C0C011
111111111111111111111
