1111111111
1C0C000001
10E0111101
1C0C1P0001
1111110101
1000000101
1011101101
1C01C01C01
10C10C10C1
1111111111
