1111111111111111111111111111111111111111
1CC0000CCC1111CCCCC1C111CCCCC000000CCCC1
1110101CCC1111101110001101111011101CCCC1
1C000011111P1E1000001000011C101110111111
10111011111010111110001101CC100000000001
1C1CC00000000000001101110101101111111101
101CC011101110CC100C0C0C0C00001000001001
1C1CC01CC01000CC10C0C0C0C0C1111011101011
1011111111101111111011111111100001000001
1C000C0100001111CC101CC00111001001011111
111011010110111C0000000CC100011100010001
1CC0110001C0111C10101CC00101110111110C01
111C00C1C11C111C1C10100CC100000000000001
1111111111111111111111111111111111111111
