111111111
100C000E1
100111111
101100001
10C0C0C01
100C0C001
10C0C0C01
111101111
111000111
111000111
111000111
111101111
100000001
100000001
100000001
100000001
100000001
100000001
100000001
100000001
100000001
100000001
100000001
100000001
100000001
100000001
100000001
100000001
1000P0001
100000001
111111111
