111111111
110CCCCC1
100111111
101100001
10C0C0C01
100C0C001
10C0C0C01
111101111
111000111
1C00C00E1
111000111
1111C1111
100000001
1010C0C01
100000001
101011011
10001CCC1
111110001
1CCC1CCC1
111000001
11101CCC1
111011101
1C00CC101
1011CC101
101111101
10C100001
111101111
1C10001C1
1C00P00C1
1C10001C1
111111111
