1111111111111111
1CCCCCCCCCCCCCC1
1CECCCCCCCCCCCC1
1CCCCCCCCCCCCCC1
1CCCCCCCCCCCCCC1
1CCCCCCCCCCCCCC1
1CCCCCCCCCCCCCC1
1CCCCCCCCCCCCCC1
1CCCCCCCCCCCCCC1
1CCCCCCCCCCCCCC1
1CCCCCCCCCCCCCC1
1CCCCCCCCCCCCCC1
1CCCCCCCCCCCCCC1
1CCCCCCCCCCCCCC1
1CCCCCCCCCCCCCC1
1CCCCCCCCCCCCPC1
1CCCCCCCCCCCCCC1
1111111111111111
