111111111111111111111111111111111111111111111111111111111111111111
100000000000000000000000000000000000000000000000000000000000000001
100000000000000000000000000000000000000000000000000000000000000001
100000000000000000000000000000000000000000000000000000000000000001
100000000000000000000000000000000000000000000000000000000000000001
100000000000000000000000000000000000000000000000000CE0000000000001
100000000000000000000000000000000000000000000000000000000000000001
100000000000000000000000000000000000000000000000000000000000000001
100000000000000000000000000000000000000000000000000000000000000001
100000000000000000000000000000000000000000000000000000000000000001
100000000000000000000000000000000000000000000000000000000000000001
100000000000000000000000000000000000000000000000000000000000000001
100000000000000000000000000000000000000000000000000000000000000001
100000000000000000000000000000000000000000000000000000000000000001
100000000000110000000000000000000000000000000000000000000000000001
100000000000000000000000000000000000000010000000000000000000000001
100000000000000000000000000000000000000010000000000000000000000001
100000000000000000000000000000000000000010000000000000000000000001
100000000000000000000000000000000000000010000000000000000000000001
100000000000000000000100000000000000001110000000000000000000000001
100000000000000000000100000000000000000000000000000000000000000001
1000000000000000000001000P0000000000000000000000000000000000000001
100000000000000000000100000000000000000000000000000000000000000001
100000000000000000000000000000000000000000000000000000000000000001
100000000000000000000000110001111100000000000000000000000000000001
100000000000000000000000000000000000110000000000000000000000000001
100000000000000000000000000000000000000100000000000000000000000001
100000000000000000000000000000000000000100000000000000000000000001
100000000000000000000000000000000000000000000000000000000000000001
100000000000000000000000000000000000001000000000000000000000000001
100000000000000000000000000000000000010000000000000000000000000001
100000000000000000000000000000000001110000000000000000000000000001
100000000000000000000000000000000000110000000000000000000000000001
100000000000000000000000000000000000000000000000000000000000000001
100000000000000000000000000000000000000000000000000000000000000001
100000000000000000000000000000000000000000000000000000000000000001
100000000000000000000000000000000000000000000000000000000000000001
100000000000000000000000000000000000000000000000000000000000000001
100000000000000000000000000000000000000000000000000000000000000001
111111111111111111111111111111111111111111111111111111111111111111
