111111111111111111111111111111111111111111111111111111111111111111
100000000000000000000000000000000000000000000010000000000000000001
100000000000000000000000000000000000000000000010000000000000000001
100000000000000000111111100000000000000000000100000000000000000001
100000000000000001000000011110000000000000000000000000000000000001
100000000000000000000000000001000000000000000100000000000E00000001
100000000001000000000C00000001000000000000000100000000000000000001
1000000C0001000000000000000000000000000000000010000000000000000001
100000000001000000000000000000000000000000000001000000000000000001
111011111111000000000000000100000000000000000001000000000000111001
100000000000000000000000000000000000000000000000000000000001000001
100000000000000000000011110000000000000000000000010000000010000001
100000000000000000111000000000011000000000000000001110000010000001
100000000000000000000000000001111000000000000000000001110000000001
100000000000110000000000000001111000000000000000000000001111000001
100000000000000000000000000011110000000010000000000000000000000001
100000000000000000000000000000000000000010000000000000000000000001
100000000000000000000000000000000000000010000000001000000000000001
100000010000000000000000000000000000000010000000001000000000000001
100000010000000000000100000000100000001110000000001111100000000001
100000010000000000000100000000100000000000000000000000000000000001
1000000100000000000001000P0000100000000000000000000000000000000001
100000010000000000000100000000000000000000000000000000000000000001
100000010000000000000000000000000000000000000000000000011111011111
100000010000000000000000110001111100000000000000000111111111011111
100000010000000000000000000000000000110000000000001111111111011111
100000010000000000000000000000000000000100000000011111110000000001
100000010000000000000000000000000000000100000000011100000000000001
1000000100000000000000000000000000C0000000000000111100001100000001
100000010000000000000000000000000000001000000000111000001100000001
100000111111000000000000000000000000010000000000111000000000000001
1000000000001000000000101000000000011100000000011110000000C0000001
100000000C00100000000010100000000000110000000001110000000000000001
10000000000011000000111010000000000000000000000111000000C000C00001
100000000000000000000000100000000000000000000001110000000000000001
1000000000000000000111111000000000000000000000111100000000C0000001
100000000000000000000000000000000111000000000011100011000000011001
100000000000000000000000000000000000000000000011100011000000011001
100000000000000000000000000000000000000000000011100000000000000001
111111111111111111111111111111111111111111111111111111111111111111
